------######################################################
--------####################################################
###------###################################################
#####--------------------------#############################
########------------------------############################
#########----################---############################
##########----################-----#########################
###########----#################---#########################
############----#################---########################
#############-----##############---#########################
#############----##############---##########################
#############----#############---###########################
#############----############---############################
##############----##########---#############################
###############----########---##############################
##############-----#######---###############################
#############-----########---###############################
#############-----#######----###############################
#############-----#########---##############################
#############-----#########---##############################
##############----##########---#############################
###############----#########---#############################
################----########---#############################
#################----######-----############################
###################------------#############################
###################-----------##############################
############################################################
############################################################
############################################################
############################################################
############################################################
############################################################
############################################################
############################################################
############################################################
############################################################
############################################################
############################################################
############################################################
############################################################
############################################################
############################################################
############################################################
############################################################
############################################################
0 0
