############################################################
-----------------------------------------------------------#
---------#############-------------------------------------#
#----------------------------------------------------------#
#---------------------------------------#############------#
#----------------------------------------------------------#
#---------------#############------------------------------#
#----------------------------------------------------------#
#----------------------------------------------------------#
#----------------------------------------------------------#
---------------------------------#--------------------------
---------------------------------#--------------------------
---------------------------------#--------------------------
---------------------------------#--------------------------
--------------#######------------#-------------------------#
--------------#------------------#-------------------------#
--------------#------------------#-------------------------#
--------------#------------------#--------------#----------#
--------#-----#------------------#--------------#----------#
--------#-----#------------------#--------------#-----------
--------#-----#----------###############--------------------
--------#-----#---------------------------------------------
--------#-----#---------------------------------------------
--------#---------------------------------------------------
--------#---------------------------------------------------
--------#---------------------------------------------------
--------#######---------------------------------------------
---------------------#-----------#--------------------------
---------------------#-----------#--------------------------
---------------------#-----------#--------------------------
---------------------#-----------#--------------------------
---------------------######---####--------------------------
--------------------------#---------------------------------
--------------#############---------------------------------
-----------------------------------------#############------
---------------------------------#--------------------------
---------------------------------#--------------------------
---------------------------------#--------------------------
------------#############--------#--------------------------
---------------------------------#--------------------------
---------------------------------#--------------------------
---------------------------------#--------------------------
--------------------------------###-------------------------
---##---------------------------###------####---------------
----##-------------------------------------##---------------
-----##------------------------------------##---------------
------#------------------------------------##---------------
------##-----------------------------------##---------------
-------##----------------------------------##---------------
--------#####------------------------------##---------------
---------#---------------------------------##---------------
-------------------------------------------##---------------
-------------------------------------------##---------------
-------------------------------------------##---------------
###########--------##################################-----##
#-----------------------------#####------------------------#
#----------------------------------------------------------#
#------------------------------###-------------------------#
#-----------------------------#####------------------------#
############################################################
300 200
